Welcome. For a brief tutorial, type "tutorial" and press enter. If you know how to play, begin typing commands below.

Oxygen
An Interactive Fiction by Hansi Berlin
Release 1 / Serial number 170714 / Inform 7 build 6M62 (I6/v6.33 lib 6/12N) SD

The Parlor
A rather small front parlor, with a view of the lawn. Some dusty, old furniture is scattered around; it is of modest style. A faded oriental rug covers a small portion of the cold floor. The only exit is to the west.

>examine self
You are unstable. Looking down at yourself, you see that you are shaking slightly. By a conscious effort, you manage to make youself calm down, but you are still uneasy.

>take inventory
You are carrying:
  a burgundy waistcoat (being worn)

>take off waistcoat
You take off the burgundy waistcoat.

* * *

>examine self
You are unstable. Looking down at yourself, you see that you are shaking slightly. By a conscious effort, you manage to make youself calm down, but you are still uneasy.

>examine moon
The pale moonlight streams through the windows, reminding you of what you've done.

>examine self
You are paranoid. Looking down at yourself, you see that you are paler than usual, and a bit more wasted. It's this house. It has to be this house.

>think
What a good idea.

>examine self
You are losing it. Looking down at yourself, you see a pale, nearly skeletal being. Looking upon yourself is akin to looking at death its self.

>examine moon
The pale moonlight streams through the windows, reminding you of what you've done.

>examine self
You are clinically insane. Looking down at yourself, you see the odd perversion of the human form that is supposed to pass as your body. You can see your pulse in your hands, carrying on obliviously.

>think
What a good idea.

>examine self
You are raving mad. Looking down at yourself, you see the red colour of your waistcoat begins to run, following the lines of your veins, pulsing along with your blood. The more you try to wipe away the stains with your hands, the more they begin to bleed.

* * *

>examine self
You are unstable. Looking down at yourself, you see that you are shaking slightly. By a conscious effort, you manage to make youself calm down, but you are still uneasy.

>inventory
You are carrying:
  a burgundy waistcoat (being worn)
  a black trousers (being worn)
  a broken pocketwatch (being worn)
  a handkerchief

>examine waistcoat
A dark red waistcoat, the only one you had the presence of mind to bring with you, apparently.

>examine trousers
A pair of normal, black trousers.

>examine watch
A silver pocketwatch that hasn't been working properly for years.

>think about watch
It stopped working properly after it was dropped into a washbasin, many years ago. You really don't want to think about that event...

>think about event
You can't quite remember what precisely went on, but you feel distinctly traumatized whenever you think about that night so many years ago. The most you can recall is the sound of gunfire and a child's crying.

>examine self
You are paranoid. Looking down at yourself, you see that you are paler than usual, and a bit more wasted. It's this house. It has to be this house.

>think about moon
The same old moon that has doubtless watched millions of events like the one you have experienced.

>examine self
You are paranoid. Looking down at yourself, you see that you are paler than usual, and a bit more wasted. It's this house. It has to be this house.

>think about self
You find yourself kind of pathetic at the moment. An old manservant lurking about the house he once served.

>examine self
You are paranoid. Looking down at yourself, you see that you are paler than usual, and a bit more wasted. It's this house. It has to be this house.

>think about master
Through all of this, all these years, the master is the one thing you can remember properly. A tall man, of middle age, with iron gray hair and a serious face. He walked with a limp, due to an injury sustained in some vague accident he never spoke of. And then, standing at the top of the stairs, staring at you with a cruel look you hadn't thought him capable of until you saw it for yourself.

>examine self
You are losing it. Looking down at yourself, you see a pale, nearly skeletal being. Looking upon yourself is akin to looking at death its self.

>attack self
Violence isn't the answer to this one.

>go south
You can't go that way.

>to west
That's not a verb I recognise.

>go west
The Hall
A slight, but piercingly cold draft wafts through the cave-like room, which is tastefully, if not coldly, decorated. The staircase leads to the darkness of the second floor, which seems to be observing you somehow. Every direction except the north, the southeast and the southwest has an exit, shrouded in obscurity that makes you very reluctant to enter any of them.

>go west
The Music Room
You can remember short snippets of the music that  once played here. It saddens you immensely, knowing full well that such music will never again grace this house.The conservatory is to the west, and the hall is to the east.

>go east
The Hall
A slight, but piercingly cold draft wafts through the cave-like room, which is tastefully, if not coldly, decorated. The staircase leads to the darkness of the second floor, which seems to be observing you somehow. Every direction except the north, the southeast and the southwest has an exit, shrouded in obscurity that makes you very reluctant to enter any of them.

>go east
The Parlor
A rather small front parlor, with a view of the lawn. Some dusty old furniture is shaded in the darkened corners, like animals waiting to pounce. The room has an odd sense of life to it, and it is certainly not a benevolent existence. The only exit, to the west, seems vaguely threatening.

>go west
The Hall
A slight, but piercingly cold draft wafts through the cave-like room, which is tastefully, if not coldly, decorated. The staircase leads to the darkness of the second floor, which seems to be observing you somehow. Every direction except the north, the southeast and the southwest has an exit, shrouded in obscurity that makes you very reluctant to enter any of them.

>go southeast
You can't go that way.

>go northeast
The Dining Room
A large, dim room, with too many blind spots for you to be at ease. (Exits to the southwest and the north.)

A fine layer of dust covers everything, as seems to be true of everything in the house.

A tattered tablecloth runs the length of the table, one that you dimly remember seeing before.

A big, oval-shaped table takes up most of the room. Even now it is in good shape, a testament to its workmanship.

>wear tablecloth
(first taking the tattered tablecloth)
Sending up a cloud of dust, you remove the tablecloth from the table.

You wrap the tablecloth about yourself like a cloak.

* * *

Welcome. For a brief tutorial, type "tutorial" and press enter. If you know how to play, begin typing commands below.

Oxygen
An Interactive Fiction by Hansi Berlin
Release 1 / Serial number 170714 / Inform 7 build 6M62 (I6/v6.33 lib 6/12N) SD

The Parlor
A rather small front parlor, with a view of the lawn. Some dusty, old furniture is scattered around; it is of modest style. A faded oriental rug covers a small portion of the cold floor. The only exit is to the west.

>examine rug
Its once intricate patterns have faded almost to obscurity, the constant light having leeched the formerly brilliant dyes.

>examine moon
You can't see any such thing.

>look at moon
You can't see any such thing.

>examine self
Looking down at yourself, you see that you are shaking slightly. By a conscious effort, you manage to make youself calm down, but you are still uneasy.

* * *

Welcome. For a brief tutorial, type "tutorial" and press enter. If you know how to play, begin typing commands below.

Oxygen
An Interactive Fiction by Hansi Berlin
Release 1 / Serial number 170714 / Inform 7 build 6M62 (I6/v6.33 lib 6/12N) SD

The Parlor
A rather small front parlor, with a view of the lawn. Some dusty, old furniture is scattered around; it is of modest style. A faded oriental rug covers a small portion of the cold floor. The only exit is to the west.

>examine furniture
A dusty old couch, a tattered chaise longue... None of it really anything out of the ordinary.

>examine carpet
Its once intricate patterns have faded almost to obscurity, the constant light having leeched the formerly brilliant dyes.

>examine lawn
The full moon illuminates the damp grass. The soft, rolling hills are cut off suddenly by the iron fence that encloses the property.

>examine moon
The pale moonlight streams through the windows, reminding you of what you've done.

* * *

>examine furniture
A dusty old couch, a tattered chaise longue... None of it really anything out of the ordinary.

>take apart furniture
You can't see any such thing.

>take furniture apart
Being somewhat broken after such a long time without maintainance, it is easy to take apart.

>examine furniture
A large pile of wood and stuffing

* * *

>examine furniture
A dusty old couch, a tattered chaise longue... None of it really anything out of the ordinary.

>sit on furniture
It seems too fragile to do that.

>tap furniture
That's not a verb I recognise.

>take apart furniture
Being somewhat broken after such a long time without maintainance, it is easy to take apart.

>pick up furniture
You haven't any use for it.

>take rug
It's too cumbersome to carry around with you.

>kick rug
That's not a verb I recognise.

>go west
The Hall
 An attractive, tasteful room. The high ceilings conceal years of cobwebs. A large staircase leads to the shadowy reaches of the second floor. Being the heart of the house, there are exits in every direction besides the north, the southwest, and southeast.

>go northeast
The Dining Room
A dining room that is a bit larger than usual, but, like the hall, very tastefully adorned. Simple mouldings are present around the ceiling, and the deep rose colour of the walls imparts a sense of calm. The kitchen is to the north, but otherwise, you can only go back to the hall (southwest).

A fine layer of dust covers everything, as seems to be true of everything in the house.

A tattered tablecloth runs the length of the table, one that you dimly remember seeing before.

A big, oval-shaped table takes up most of the room. Even now it is in good shape, a testament to its workmanship.

>take tablecloth
Sending up a cloud of dust, you remove the tablecloth from the table.

Taken.

>go north
The Kitchen
A very mundane kitchen. A hearth stands in the center of the room, the ashes of a fire long since burnt out all that remains of a once busy portion of the house. The pantry is to the west, and the dining room is to the south. The servants' quarters are to the north.

A single kitchen knife, slightly rusted, sits on the countertop.

Ashes have been scattered by the wind, covering the floor in a fine, dark layer.

>take knife
Taken.

>go north
The Servants' Quarters
The chamber in which the servants once lived. It  is more plainly decorated than the rest of the house, and understandably so. You can remember many pleasant evenings spent here. The only exit is back to the south.

The back door seems to have rotted, on the northern face of the house exposed directly to wind and rain.

The sheets, though dusty, are as stainless as the day they were abandoned.

Three cots are arranged along the back wall, in exactly the same state as they were when everyone left.

>think
What a good idea.

>think about servants
You can't see any such thing.

>think about evenings
You can't see any such thing.

>go to door
You can't see any such thing.

>go south
The Kitchen
The wind howling down the unprotected chimney makes a mournful sound, one that plays on your nerves. Otherwise, this seems to be a very average kitchen, with a pantry off the western wall and a dining room to the south. The servants' quarters are to the north.

Ashes have been scattered by the wind, covering the floor in a fine, dark layer.

>go south
The Dining Room
Large and drafty, this is a rather cold room. Once again, you feel as if you are being watched.(Exits to the southwest and the north.)

A fine layer of dust covers everything, as seems to be true of everything in the house.

A big, oval-shaped table takes up most of the room. Even now it is in good shape, a testament to its workmanship.

>go southwest
The Hall
The large, open room makes you feel as if you are being watched. You shiver as the chill air hits you. The staircase leads up into the obscurity of the second floor. There are exits in every direction except the north, the southwest, and the southeast.

>go northeast
The Dining Room
Large and drafty, this is a rather cold room. Once again, you feel as if you are being watched.(Exits to the southwest and the north.)

A fine layer of dust covers everything, as seems to be true of everything in the house.

A big, oval-shaped table takes up most of the room. Even now it is in good shape, a testament to its workmanship.

>go southwest
The Hall
The large, open room makes you feel as if you are being watched. You shiver as the chill air hits you. The staircase leads up into the obscurity of the second floor. There are exits in every direction except the north, the southwest, and the southeast.

>go south
The Foyer
A cramped, windowless room at the front of the house. The front door, long since boarded over, blocks any new air from entering, giving the room a suffocating atmosphere. The only way to go seems to be back to the north.

A scattering of colourful shards of broken glass cover the floor by the front door. The reds stand out expecially, shining like rubies.

>break glass
Violence isn't the answer to this one.

>take glass
Carefully grasping one of the more intact pieces of glass with your hand-kerchief, you take it with you.

Taken.

>stare at glass
That's not a verb I recognise.

>examine glass
Once a brilliantly coloured stained glass window, the glass is now but a collection of razor sharp fragments.

>think
What a good idea.

>think about glass
It must have happened when the police arrived, though you were being treated by the surgeon, seven miles down the road, by the time they got here.

>think about injury
It was the master that had taken the shot, though you know he had been aiming at your chest. It was only your agility that had saved your life.

>think about master
Through all of this, all these years, the master is the one thing you can remember properly. A tall man, of middle age, with iron gray hair and a serious face. He walked with a limp, due to an injury sustained in some vague accident he never spoke of. And then, standing at the top of the stairs, staring at you with a cruel look you hadn't thought him capable of until you saw it for yourself.

>think about master
Through all of this, all these years, the master is the one thing you can remember properly. A tall man, of middle age, with iron gray hair and a serious face. He walked with a limp, due to an injury sustained in some vague accident he never spoke of. And then, standing at the top of the stairs, staring at you with a cruel look you hadn't thought him capable of until you saw it for yourself.

>go south
You can't go that way.

>go north
The Hall
A slight, but piercingly cold draft wafts through the cave-like room, which is tastefully, if not coldly, decorated. The staircase leads to the darkness of the second floor, which seems to be observing you somehow. Every direction but the north, the southeast and the southwest has an exit, shrouded in obscurity that makes you very reluctant to enter any of them.

>go east
The Parlor
A rather small front parlor, with a view of the lawn. Some dusty old furniture is shaded in the darkened corners, like animals waiting to pounce. The room has an odd sense of life to it, and it is certainly not a benevolent existence. The only exit, to the west, seems vaguely threatening.

>think about corners
You can't see any such thing.

>stare at moon
That's not a verb I recognise.

>look at moon
The pale moonlight streams through the windows, reminding you of what you've done.

>think about moon
The same old moon that has doubtless watched millions of events like the one you have experienced.

>think about what I've done
You can't see any such thing.

>think about moon
The same old moon that has doubtless watched millions of events like the one you have experienced.

>think
What a good idea.

>think
What a good idea.

>cut
What do you want to cut?

>arm
You can't see any such thing.

>cu arm
That's not a verb I recognise.

>cut arm
You can't see any such thing.

>cut some
You can't see any such thing.

>cut self
*** With shaking hands, you hold the knife to your neck. It hardly takes a moment for you to draw the edge across your throat, bringing a gush of blood to the surface. You barely have the time to realize that you are dying before you pass out from the blood loss. And so it is that you join the other former tenants of the house. ***

Would you like to RESTART, RESTORE a saved game, QUIT or UNDO the last command?

>undo
The Parlor
[Previous turn undone.]

>go west
The Hall
The large, cavernous room seems to act as an amplifier to your fevered thoughts, making them so loud that you believe they are going to deafen you permanently. A thousand doors open to you on every side, each of them inviting you into the sweet oblivion of madness.

>go west
The Music Room
Fragmented pieces of melodies heard long ago crowd your mind, almost as deafening as the breathing of the hall.

>go west
The Conservatory
The remains of the once vivid plants cling to you as you pass, pushing through the overgrown conservatory. The moon looms large overhead, searingly bright through the glass walls.

>take plant
You can't see any such thing.

>examine moon
The moon stares through the window at you. It's watching. It was watching you then, when you did it, and it sees you now, squirming beneath its impartial eye.